#######################################
# Syntax Coloring Map For FaBoEnvironment-BME680-Library
#######################################

#######################################
# Class (KEYWORD1)
#######################################

BME680C	KEYWORD1
CalibraBME680	KEYWORD1
LiquidCrystal_I2C	KEYWORD1
LabMovEsp32	KEYWORD1
DateTime	KEYWORD1
TimeSpan	KEYWORD1
RTC_DS3231	KEYWORD1
Ds3231SqwPinMode	KEYWORD1
Ds3231Alarm1Mode	KEYWORD1
Ds3231Alarm2Mode	KEYWORD1

#######################################
# Methods and Functions (KEYWORD2)
#######################################

begin	KEYWORD1
CalibraBegin	KEYWORD1
setParam	KEYWORD1
setSensor	KEYWORD1
setMode		KEYWORD1
getOversamplingDuration	KEYWORD1
readSensors	KEYWORD1
SensorValor	KEYWORD1

init	KEYWORD2
clear	KEYWORD2
home	KEYWORD2
noDisplay	KEYWORD2
display	KEYWORD2
noBlink	KEYWORD2
blink	KEYWORD2
noCursor	KEYWORD2
cursor	KEYWORD2
scrollDisplayLeft	KEYWORD2
scrollDisplayRight	KEYWORD2
leftToRight	KEYWORD2
rightToLeft	KEYWORD2
shiftIncrement	KEYWORD2
shiftDecrement	KEYWORD2
noBacklight	KEYWORD2
backlight	KEYWORD2
autoscroll	KEYWORD2
noAutoscroll	KEYWORD2
createChar	KEYWORD2
setCursor	KEYWORD2
print	KEYWORD2
blink_on	KEYWORD2
blink_off	KEYWORD2
cursor_on	KEYWORD2
cursor_off	KEYWORD2
setBacklight	KEYWORD2
load_custom_character	KEYWORD2
printstr	KEYWORD2
isValid	KEYWORD2
year	KEYWORD2
month	KEYWORD2
day	KEYWORD2
hour	KEYWORD2
twelveHour	KEYWORD2
isPM	KEYWORD2
minute	KEYWORD2
second	KEYWORD2
dayOfTheWeek	KEYWORD2
secondstime	KEYWORD2
unixtime	KEYWORD2
days	KEYWORD2
hours	KEYWORD2
minutes	KEYWORD2
seconds	KEYWORD2
totalseconds	KEYWORD2
begin	KEYWORD2
adjust	KEYWORD2
adjustDrift	KEYWORD2
isrunning	KEYWORD2
now	KEYWORD2
readSqwPinMode	KEYWORD2
writeSqwPinMode	KEYWORD2
timestamp	KEYWORD2
toString	KEYWORD2
readnvram	KEYWORD2
writenvram	KEYWORD2
setAlarm1	KEYWORD2
setAlarm2	KEYWORD2
disableAlarm	KEYWORD2
clearAlarm	KEYWORD2
alarmFired	KEYWORD2
getTemperature	KEYWORD2
lostPower	KEYWORD2
initialized	KEYWORD2
enableSecondTimer	KEYWORD2
disableSecondTimer	KEYWORD2
enableCountdownTimer	KEYWORD2
disableCountdownTimer	KEYWORD2
deconfigureAllTimers	KEYWORD2
calibrate	KEYWORD2
enable32K   KEYWORD2
disable32K    KEYWORD2
isEnabled32K    KEYWORD2

#######################################
# Constants (LITERAL1)
#######################################

TIMESTAMP_FULL	LITERAL1
TIMESTAMP_DATE	LITERAL1
TIMESTAMP_TIME	LITERAL1
